11111111111111111111111111111111111
1CE00100000000100000000000000000001
111000000110C0001111111111111111101
100000C0001111111000000000000000101
100000000000000000C0000F00111000101
100000000000000000000000001C1000101
10000000000000C00000000000000000101
10000000110000000010000000000000101
11101000110000N0000000000011110C101
10001000000001C10000000000100000101
10001000000000100000000000000101101
1C001000000000001000000000001001011
11111000110000001000000000001111111
1P000010000000000000000000000000011
11111111111111111111111111111111111