111111111111
1P00000000C1
101111111101
1C00000010E1
111110001111
1C0000000001
111111111111