1111111111111
1P00100000111
11C0001110001
1111111C11101
1E00000000001
1111111111111
