111111111111
1P00001000C1
101111111101
1C00000000E1
111111111111