11111111
100N0001
100F0001
1PC000E1
11111111