1111111111111
1P00100000111
11C0001110001
1111111C11101
1C000000000E1
1111111111111
