111111111111111111111111111111111111
1E00011111011110000000P0000000000001
100000000000C00011111111111111111101
100000C00011111100000000000000000101
1100000000000000000C0000000010000101
110000000000000000000000000101000101
11000000000000C000000000000000000101
110000001100000000010000000000000101
1100000011000000000F000000011110C101
110000000000000C00000000000100000101
11000C000000000110000000000000001101
1100000000000000010C00000C0000010001
111110001100000000000000000000111111
1000001000000000000C0000N00000000001
111111111111111111111111111111111111