111111111111111
1P001C0001C01C1
111010110110101
11100011C110101
1C0010011100001
111111000001C01
1C00E1111111101
100000000000001
111111111111111