111111111111111
1P001C0001C00C1
111010110110001
10000011C110001
1C0010011100001
111111000001C01
1C00E1111111101
1NFB00000000001
111111111111111