11111111111111111
1P1E00010000000C1
101111000111C0111
1000C1C100C110001
10011111111100101
101100000C1101101
10000011100101001
1111111C110101011
1C1C1C10110101001
101010000001C1101
10101001111111001
100010010000C1001
11101101011111001
1C000000000000011
11111111111111111