111111111
1P00000C1
1000F0111
1B00N00E1
111111111