111111111
1P00001C1
1000F0111
1000N00E1
111111111