111111111
1P00000C1
1000F0001
1000N00E1
111111111