111111111
1P00000C1
100000111
1000000E1
111111111