111111111111111111111111111111111111
1C0001111101111000000000000000000001
111100100000C00011111111111111111101
100000C000111111000000000B0000000101
1100111000000000000C1111000010000101
1100010000000000000010C1111101000101
1100011010000CF000001000100000001C01
110000001000000000011110000000000101
11001000100000000000000000011110C101
110010001000000C00000000000100000101
110011111111110110000000000000001101
11C0100000000100010C00N00C000001E001
111110001111010000000000000000111111
1P0000011C000000000C00000000000000C1
111111111111111111111111111111111111