1111111111111111111111111111111111111111111111111111111111111111111111
1P00001000000000000C1100C0011111C011100000011000000000000000000000C111
1111001001111100111111000000110110000000001110000000000011100011111111
1C01001001000000000000001111110000000001111111111100001111100000011111
1001000001000000000000011100000111100000000000000000001100000000000111
10010011110011111111100110000111C0000001110000000000011110000111100011
100000111100111111111001100000011111100011100111110000000000000C110011
11111111110011000C1110011000000000011111100001111111111111111111110011
1000000000001100011110000000011110000000000000000000000011C00000000011
1000000000001100111000001100001100000000000000000000000011000000000011
100111111111110000000001110000000000110000F000011110000011111111100011
1001100000000000111100011100000000011000000000110011000000000000000111
1001100000000000111000111100000000110011000001100001100000111111111111
10011000000000000011000000000000011C001100000000001100000000111C000111
1001111100000000000110000000000011111111111000000110000111111100001111
10000C111111C0000001100000N0000000000011000000001100000011100000011111
1000000000111111111110000000000000000011000000011C00000011111000111111
1000000000000000C11111100000011100000011000000111111100000000000000111
1111111111000111111110000000000000000000000000000000000011001100000011
1000000000000111110000001111111000011111000011000111000111001100011111
1000011111111111110000011000C11100011110000111000000001111111100001111
100001111000000001C000000001111100000111111110001111001110000000000111
1110011100000001111110001111100000011111110000000111000110000000001111
1110011100000001110000000011111000011000000001111000000110000111111111
1110111110000001111000001111000001100000000111111111100111100000001111
11001111111000011000111111000001110110000000000111C0000111111001100011
111001110000111111000000000001110C0000011111100011111100111C0011000111
110011C000000000111111111001111111111000001111100000111111111110011C11
111001111111000011C111100000000000011111000011111C00001111110000011111
1C0000000000000011000000001111100000000000111110000011111C0000000000E1
1111111111111111111111111111111111111111111111111111111111111111111111