111111111111111111111111111111111111
100001000000001000000000000000000001
10F000000110C00011111111111111111101
100000C00011111100000000000000000101
1000000000000000000C0000F00010000101
100000000000000000000000000101000101
10000000000000C000000000000000000101
10000000110000000001000F000000000101
11101000110000000000000000011110C101
100010000000001C10000000000100000101
10001C000F00000100000000000000001101
1C00100000000000010C00000C000001E001
111110001100000001000000000000111111
1P00001000000000000C000000F000000001
111111111111111111111111111111111111