1111111111111111111111111111111111
1P1E000000000000000000000000000001
1011111111111100111111111111111101
101C0000000001001000C000000010C101
1011111111100100111111111000100101
1000C1F000000100100000000000110101
1110110000000000000111111111110001
100010000111111111111C000000011101
1101000001000C00001C0111111001C001
1001000001000000001101C00000011101
1011000001000000000101111111000001
1001C00001111111001100000000001101
1101000000000000000111111111111001
10011100011110000111000000000C0101
1011C10000001000000000000000000101
1000011111001111110000000000001C01
1111000000001000000000000000000101
1B00000000001C00000001100000001001
1000011111001111111000000001111101
10001C00000000000000000110000C0101
1001000001111111111111111111111001
11C100000001100000000000N000001101
1111001110000001110001100000001C01
1C000010111110001C0000000000001101
1001111000000001111111000000001001
1111C10000111111000000000000001011
100000000001C000000111100000000001
1111111110010000000000111111111111
1C000000000000011000000000000000C1
1111111111111111111111111111111111