111111111111111111111111111111111111111111111
11P00000000000000C110000011000000011000000C11
1111111111100111111100B0000000110000000110011
11C000000000000000000001111111111111111110011
110011111111111111110001100000011000000110011
1100000000000C11C000000000011000000110C110011
110111111111001111100011111111111111111110011
1100111C011100110000000011C000000000000111011
1110C111000000111000N00011000F000011110C11011
1E11111111111111C000000C11000000001C000111011
1011111C0000001111111111110000000011111110011
100000000000000000000000000000000000000000011
111111111111111111111111111111111111111111111