1111111111111111
1P001C0001C01C01
1110101101101001
11000011C1101001
1C00100111000001
1C00100010000001
111111000001C001
1C00E11111111001
1FN0000000000001
1111111111111111